*****.******
******.***##
*****.***###
*****.**####
****.*######
###**.*.***#
####**.****#
#..#.*.*.*.#