*****.******
******.***##
*****.***###
*****.**####
****.*######
###**.*****#
####**.****#
#..#.*.*.*.#