*****.******
******.***##
*****.***###
*****.**####
****.*######
###**.*****#
####**.****#
#..#.*.*.*.#
*****.******
******.***##
*****.***###
*****.**####
****.*######
###**.*****#
####**.****#
#..#.*.*.*.#
....*.*.*.*.
*.*.#..*.*##
**#*.*.*###.
**.**.**####
**.*.*######
###**.*.*.*#
####**.**.*#
#..#.*.*.*.#
....*.*.*.*.
*.*.#..*.*##
**#*.*.*###.
**.**.**####
**.*.*######
###**.*.*.*#
####**.**.*#
#..#.*.*.*.#
*****.******
******.***##
*****.***###
*****.**####
****.*######
###**.*****#
####**.****#
#..#.*.*.*.#
*****.******
******.***##
*****.***###
*****.**####
****.*######
###**.*****#
####**.****#
#..#.*.*.*.#
....*.*.*.*.
*.*.#..*.*##
**#*.*.*###.
**.**.**####
**.*.*######
###**.*.*.*#
####**.**.*#
#..#.*.*.*.#
....*.*.*.*.
*.*.#..*.*##
**#*.*.*###.
**.**.**####
**.*.*######
###**.*.*.*#
####**.**.*#
#..#.*.*.*.#