....*.*.*.*.
*.*.#..*.*##
**#*.*.*###.
**.**.**####
**.*.*######
###**.*.*.*#
####**.**.*#
#..#.*.*.*.#
....*.*.*.*.
*.*.#..*.*##
**#*.*.*###.
**.**.**####
**.*.*######
###**.*.*.*#
####**.**.*#
#..#.*.*.*.#
....*.*.*.*.
*.*.#..*.*##
**#*.*.*###.
**.**.**####
**.*.*######
###**.*.*.*#
####**.**.*#
#..#.*.*.*.#
....*.*.*.*.
*.*.#..*.*##
**#*.*.*###.
**.**.**####
**.*.*######
###**.*.*.*#
####**.**.*#
#..#.*.*.*.#